1110000191
2931100111
3939321000
9433991000
9492221000
2921001110
1110001910
0000001221
1110000191
1911111221
1122923920
0019393931
0011212129
0000111011
0000191000
