0019100000
1132200000
1929111111
1232119119
0191011111
0111000000
0001110011
0013920019
0019931011
1123491000
9229211122
2921100199
1221111122
0192292110
0112922910
