0000019229
0011222292
0029391111
0029422110
0012911910
0112111121
0191000019
0111001132
0111001939
1291001292
9211000111
1101110111
0001910191
0013320122
0019910019
