0011100000
0019100111
0011100292
0000000292
0000000111
0111000000
0191000011
0111000029
0111111139
0191192292
0111129222
0000022219
0000019111
0000011100
0000000000
