0001291191
1101921111
9101222110
1100193920
0111113920
1292101110
1939100000
1121100000
1122321000
1929992011
1123992129
1111221192
1910000222
1110000191
0000000111
